MapName: "Map";
MapLength: "144";
MapHeight: "144";
MapData:
"111111111111111111111111111111111111111111111111111111111111111111111111111111111111111111111111111111111111111111111111111111111111111111111111
111111111111111111111111111111111111111111111111111111111111111111111111111111111111111111111111111111111111111111111111111111111111111111111111
110000000000000000000000000000000000000000000000000000000000000000000000000000000000000000000000000000000000000000000000000000000000000000000011
110000000000000000000000000000000000000000000000000000000000000000000000000000000000000000000000000000000000000000000000000000000000000000000011
110000000000000000000000000000000000000000000000000000000000000000000000000000000000000000000000000000000000000000000000000000000000000000000011
110000000000000000000000000000000000000000000000000000000000000000000000000000000000000000000000000000000000000000000000000000000000000000000011
110000000000000000000000000000000000000000000000000000000000000000000000000000000000000000000000000000000000000000000000000000000000000000000011
110000000000000000000000000000000000000000000000000000000000000000000000000000000000000000000000000000000000000000000000000000000000000000000011
110000001111111111111111111111110000000111111111111111111111111000000111100000011111111111111111111111100000001111111111111111111111111000000011
110000001111111111111111111111110000000111111111111111111111111000000111100000011111111111111111111111100000001111111111111111111111111000000011
110000001100000000000000000000000000000000000000000000000000011000000111100000011000000000000000000000000000000000000000000000000000011000000011
110000001100000000000000000000000000000000000000000000000000011000000111100000011000000000000000000000000000000000000000000000000000011000000011
110000001100000000000000000000000000000000000000000000000000011000000111100000011000000000000000000000000000000000000000000000000000011000000011
110000001100000000000000000000000000000000000000000000000000011000000111100000011000000000000000000000000000000000000000000000000000011000000011
110000001100000000000000000000000000000000000000000000000000011000000111100000011000000000000000000000000000000000000000000000000000011000000011
110000001100000000000000000000000000000000000000000000000000011000000111100000011000000000000000000000000000000000000000000000000000011000000011
110000001100000000000000000000000000000000000000000000000000011000000111100000011000000000000000000000000000000000000000000000000000011000000011
110000001100000000000000000000000000000000000000000000000000011000000111100000011000000000000000000000000000000000000000000000000000011000000011
110000001100000000000000000000000000000000000000000000000000011000000111100000011000000000000000000000000000000000000000000000000000011000000011
110000001100000000000000000000000000000000000000000000000000011000000111100000011000000000000000000000000000000000000000000000000000011000000011
110000001100000000000000000000000000000000000000000000000000011000000111100000011000000000000000000000000000000000000000000000000000011000000011
110000001100000000000000000000000000000000000000000000000000011000000111100000011000000000000000000000000000000000000000000000000000011000000011
110000001100000000000000000000000000000000000000000000000000011000000000000000011000000000000000000000000000000000000000000000000000011000000011
110000001100000000000000000000000000000000000000000000000000011000000000000000011000000000000000000000000000000000000000000000000000011000000011
110000001100000000000000000000000000000000000000000000000000011000000000000000011000000000000000000000000000000000000000000000000000011000000011
110000001100000000000000000000000000000000000000000000000000011000000000000000011000000000000000000000000000000000000000000000000000011000000011
110000001100000000000000000000000000000000000000000000000000011000000000000000011000000000000000000000000000000000000000000000000000011000000011
110000001100000000000000000000000000000000000000000000000000011000000000000000011000000000000000000000000000000000000000000000000000011000000011
110000001100000000000000000000000000000000000000000000000000011000000111100000011000000000000000000000000000000000000000000000000000011000000011
110000001100000000000000000000000000000000000000000000000000011000000111100000011000000000000000000000000000000000000000000000000000011000000011
110000001100000000000000000000000000000000000000000000000000011000000111100000011000000000000000000000000000000000000000000000000000011000000011
110000001100000000000000000000011111111100000000000000000000011000000111100000011000000000000000000000111111111000000000000000000000011000000011
110000000000000000000000000000019911199100000000000000000000000000000000000000000000000000000000000000111191111000000000000000000000000000000011
110000000000000000000000000000019991999100000000000000000000000000000000000000000000000000000000000000111999111000000000000000000000000000000011
110000000000000000000000000000011999991100000000000000000000000000000000000000000000000000000000000000119999911000000000000000000000000000000011
110000000000000000000000000000011199911100000000000000000000000000000000000000000000000000000000000000199999991000000000000000000000000000000011
110000000000000000000000000000011999991100000000000000000000000000000000000000000000000000000000000000119999911000000000000000000000000000000011
110000000000000000000000000000019991999100000000000000000000000000000000000000000000000000000000000000111999111000000000000000000000000000000011
110000000000000000000000000000019911199100000000000000000000000000000000000000000000000000000000000000111191111000000000000000000000000000000011
110000001100000000000000000000011111111100000000000000000000011000000000000000011000000000000000000000111111111000000000000000000000011000000011
110000001100000000000000000000000000000000000000000000000000011000000111100000011000000000000000000000000000000000000000000000000000011000000011
110000001100000000000000000000000000000000000000000000000000011000000111100000011000000000000000000000000000000000000000000000000000011000000011
110000001100000000000000000000000000000000000000000000000000011000000111100000011000000000000000000000000000000000000000000000000000011000000011
110000001100000000000000000000000000000000000000000000000000011000000111100000011000000000000000000000000000000000000000000000000000011000000011
110000001100000000000000000000000000000000000000000000000000011000000000000000011000000000000000000000000000000000000000000000000000011000000011
110000001100000000000000000000000000000000000000000000000000011000000000000000011000000000000000000000000000000000000000000000000000011000000011
110000001100000000000000000000000000000000000000000000000000011000000000000000011000000000000000000000000000000000000000000000000000011000000011
110000001100000000000000000000000000000000000000000000000000011000000000000000011000000000000000000000000000000000000000000000000000011000000011
110000001100000000000000000000000000000000000000000000000000011000000000000000011000000000000000000000000000000000000000000000000000011000000011
110000001100000000000000000000000000000000000000000000000000011000000000000000011000000000000000000000000000000000000000000000000000011000000011
110000001100000000000000000000000000000000000000000000000000011000000111100000011000000000000000000000000000000000000000000000000000011000000011
110000001100000000000000000000000000000000000000000000000000011000000111100000011000000000000000000000000000000000000000000000000000011000000011
110000001100000000000000000000000000000000000000000000000000011000000111100000011000000000000000000000000000000000000000000000000000011000000011
110000001100000000000000000000000000000000000000000000000000011000000111100000011000000000000000000000000000000000000000000000000000011000000011
110000001100000000000000000000000000000000000000000000000000011000000111100000011000000000000000000000000000000000000000000000000000011000000011
110000001100000000000000000000000000000000000000000000000000011000000111100000011000000000000000000000000000000000000000000000000000011000000011
110000001100000000000000000000000000000000000000000000000000011000000111100000011000000000000000000000000000000000000000000000000000011000000011
110000001100000000000000000000000000000000000000000000000000011000000111100000011000000000000000000000000000000000000000000000000000011000000011
110000001100000000000000000000000000000000000000000000000000011000000111100000011000000000000000000000000000000000000000000000000000011000000011
110000001100000000000000000000000000000000000000000000000000011000000111100000011000000000000000000000000000000000000000000000000000011000000011
110000001100000000000000000000000000000000000000000000000000011000000111100000011000000000000000000000000000000000000000000000000000011000000011
110000001111111111111111111111110000000111111111111111111111111000000111100000011111111111111111111111100000001111111111111111111111111000000011
110000001111111111111111111111110000000111111111111111111111111000000111100000011111111111111111111111100000001111111111111111111111111000000011
110000000000000000000000000000000000000000000000000000000000000000000111100000000000000000000000000000000000000000000000000000000000000000000011
110000000000000000000000000000000000000000000000000000000000000000000111100000000000000000000000000000000000000000000000000000000000000000000011
110000000000000000000000000000000000000000000000000000000000000000000111100000000000000000000000000000000000000000000000000000000000000000000011
110000000000000000000000000000000000000000000000000000000000000000000111100000000000000000000000000000000000000000000000000000000000000000000011
110000000000000000000000000000000000000000000000000000000000000000000111100000000000000000000000000000000000000000000000000000000000000000000011
110000000000000000000000000000000000000000000000000000000000000000001111110000000000000000000000000000000000000000000000000000000000000000000011
110000000000000000000000000000000000000000000000000000000000000000011111111000000000000000000000000000000000000000000000000000000000000000000011
110000001111111111111100000011110000000111100000011111111111111111111111111111111111111111111000000111100000001111000000111111111111111000000011
110000001111111111111100000011110000000111100000011111111111111111111111111111111111111111111000000111100000001111000000111111111111111000000011
110000001111111111111100000011110000000111100000011111111111111111111111111111111111111111111000000111100000001111000000111111111111111000000011
110000001111111111111100000011110000000111100000011111111111111111111111111111111111111111111000000111100000001111000000111111111111111000000011
110000000000000000000000000000000000000000000000000000000000000000011111111000000000000000000000000000000000000000000000000000000000000000000011
110000000000000000000000000000000000000000000000000000000000000000001111110000000000000000000000000000000000000000000000000000000000000000000011
110000000000000000000000000000000000000000000000000000000000000000000111100000000000000000000000000000000000000000000000000000000000000000000011
110000000000000000000000000000000000000000000000000000000000000000000111100000000000000000000000000000000000000000000000000000000000000000000011
110000000000000000000000000000000000000000000000000000000000000000000111100000000000000000000000000000000000000000000000000000000000000000000011
110000000000000000000000000000000000000000000000000000000000000000000111100000000000000000000000000000000000000000000000000000000000000000000011
110000001111111111111111111111110000000111111111111111111111111000000111100000011111111111111111111111100000001111111111111111111111111000000011
110000001111111111111111111111110000000111111111111111111111111000000111100000011111111111111111111111100000001111111111111111111111111000000011
110000001100000000000000000000000000000000000000000000000000011000000111100000011000000000000000000000000000000000000000000000000000011000000011
110000001100000000000000000000000000000000000000000000000000011000000111100000011000000000000000000000000000000000000000000000000000011000000011
110000001100000000000000000000000000000000000000000000000000011000000111100000011000000000000000000000000000000000000000000000000000011000000011
110000001100000000000000000000000000000000000000000000000000011000000111100000011000000000000000000000000000000000000000000000000000011000000011
110000001100000000000000000000000000000000000000000000000000011000000111100000011000000000000000000000000000000000000000000000000000011000000011
110000001100000000000000000000000000000000000000000000000000011000000111100000011000000000000000000000000000000000000000000000000000011000000011
110000001100000000000000000000000000000000000000000000000000011000000111100000011000000000000000000000000000000000000000000000000000011000000011
110000001100000000000000000000000000000000000000000000000000011000000111100000011000000000000000000000000000000000000000000000000000011000000011
110000001100000000000000000000000000000000000000000000000000011000000111100000011000000000000000000000000000000000000000000000000000011000000011
110000001100000000000000000000000000000000000000000000000000011000000111100000011000000000000000000000000000000000000000000000000000011000000011
110000001100000000000000000000000000000000000000000000000000011000000111100000011000000000000000000000000000000000000000000000000000011000000011
110000001100000000000000000000000000000000000000000000000000011000000111100000011000000000000000000000000000000000000000000000000000011000000011
110000001100000000000000000000000000000000000000000000000000011000000000000000011000000000000000000000000000000000000000000000000000011000000011
110000001100000000000000000000000000000000000000000000000000011000000000000000011000000000000000000000000000000000000000000000000000011000000011
110000001100000000000000000000000000000000000000000000000000011000000000000000011000000000000000000000000000000000000000000000000000011000000011
110000001100000000000000000000000000000000000000000000000000011000000000000000011000000000000000000000000000000000000000000000000000011000000011
110000001100000000000000000000000000000000000000000000000000011000000000000000011000000000000000000000000000000000000000000000000000011000000011
110000001100000000000000000000000000000000000000000000000000011000000000000000011000000000000000000000000000000000000000000000000000011000000011
110000001100000000000000000000000000000000000000000000000000011000000111100000011000000000000000000000000000000000000000000000000000011000000011
110000001100000000000000000000000000000000000000000000000000011000000111100000011000000000000000000000000000000000000000000000000000011000000011
110000001100000000000000000000000000000000000000000000000000011000000111100000011000000000000000000000000000000000000000000000000000011000000011
110000001100000000000000000000011111111100000000000000000000011000000111100000011000000000000000000000111111111000000000000000000000011000000011
110000000000000000000000000000019191919100000000000000000000000000000000000000000000000000000000000000199911991000000000000000000000000000000011
110000000000000000000000000000011919191100000000000000000000000000000000000000000000000000000000000000199911991000000000000000000000000000000011
110000000000000000000000000000019191919100000000000000000000000000000000000000000000000000000000000000111111991000000000000000000000000000000011
110000000000000000000000000000011919191100000000000000000000000000000000000000000000000000000000000000111111111000000000000000000000000000000011
110000000000000000000000000000019191919100000000000000000000000000000000000000000000000000000000000000199111111000000000000000000000000000000011
110000000000000000000000000000011919191100000000000000000000000000000000000000000000000000000000000000199119991000000000000000000000000000000011
110000000000000000000000000000019191919100000000000000000000000000000000000000000000000000000000000000199119991000000000000000000000000000000011
110000001100000000000000000000011111111100000000000000000000011000000111100000011000000000000000000000111111111000000000000000000000011000000011
110000001100000000000000000000000000000000000000000000000000011000000111100000011000000000000000000000000000000000000000000000000000011000000011
110000001100000000000000000000000000000000000000000000000000011000000111100000011000000000000000000000000000000000000000000000000000011000000011
110000001100000000000000000000000000000000000000000000000000011000000111100000011000000000000000000000000000000000000000000000000000011000000011
110000001100000000000000000000000000000000000000000000000000011000000000000000011000000000000000000000000000000000000000000000000000011000000011
110000001100000000000000000000000000000000000000000000000000011000000000000000011000000000000000000000000000000000000000000000000000011000000011
110000001100000000000000000000000000000000000000000000000000011000000000000000011000000000000000000000000000000000000000000000000000011000000011
110000001100000000000000000000000000000000000000000000000000011000000000000000011000000000000000000000000000000000000000000000000000011000000011
110000001100000000000000000000000000000000000000000000000000011000000000000000011000000000000000000000000000000000000000000000000000011000000011
110000001100000000000000000000000000000000000000000000000000011000000000000000011000000000000000000000000000000000000000000000000000011000000011
110000001100000000000000000000000000000000000000000000000000011000000111100000011000000000000000000000000000000000000000000000000000011000000011
110000001100000000000000000000000000000000000000000000000000011000000111100000011000000000000000000000000000000000000000000000000000011000000011
110000001100000000000000000000000000000000000000000000000000011000000111100000011000000000000000000000000000000000000000000000000000011000000011
110000001100000000000000000000000000000000000000000000000000011000000111100000011000000000000000000000000000000000000000000000000000011000000011
110000001100000000000000000000000000000000000000000000000000011000000111100000011000000000000000000000000000000000000000000000000000011000000011
110000001100000000000000000000000000000000000000000000000000011000000111100000011000000000000000000000000000000000000000000000000000011000000011
110000001100000000000000000000000000000000000000000000000000011000000111100000011000000000000000000000000000000000000000000000000000011000000011
110000001100000000000000000000000000000000000000000000000000011000000111100000011000000000000000000000000000000000000000000000000000011000000011
110000001100000000000000000000000000000000000000000000000000011000000111100000011000000000000000000000000000000000000000000000000000011000000011
110000001100000000000000000000000000000000000000000000000000011000000111100000011000000000000000000000000000000000000000000000000000011000000011
110000001100000000000000000000000000000000000000000000000000011000000111100000011000000000000000000000000000000000000000000000000000011000000011
110000001100000000000000000000000000000000000000000000000000011000000111100000011000000000000000000000000000000000000000000000000000011000000011
110000001100000000000000000000000000000000000000000000000000011000000111100000011000000000000000000000000000000000000000000000000000011000000011
110000001111111111111111111111110000000111111111111111111111111000000111100000011111111111111111111111100000001111111111111111111111111000000011
110000001111111111111111111111110000000111111111111111111111111000000111100000011111111111111111111111100000001111111111111111111111111000000011
110000000000000000000000000000000000000000000000000000000000000000000000000000000000000000000000000000000000000000000000000000000000000000000011
110000000000000000000000000000000000000000000000000000000000000000000000000000000000000000000000000000000000000000000000000000000000000000000011
110000000000000000000000000000000000000000000000000000000000000000000000000000000000000000000000000000000000000000000000000000000000000000000011
110000000000000000000000000000000000000000000000000000000000000000000000000000000000000000000000000000000000000000000000000000000000000000000011
110000000000000000000000000000000000000000000000000000000000000000000000000000000000000000000000000000000000000000000000000000000000000000000011
110000000000000000000000000000000000000000000000000000000000000000000000000000000000000000000000000000000000000000000000000000000000000000000011
111111111111111111111111111111111111111111111111111111111111111111111111111111111111111111111111111111111111111111111111111111111111111111111111
111111111111111111111111111111111111111111111111111111111111111111111111111111111111111111111111111111111111111111111111111111111111111111111111";